XXXXX XXX
X       X
X XXX XXX
X X X   X
X X XXXXX
X       X
XXXXX XXX
XXXXX XXX
X       X
X XXX XXX
X X X   X
X X XXXXX
X       X
XXXXX XXX
X       X
X X XXXXX
X X X   X
X XXX XXX
X       X
XXXXX XXX
XXXXX XXXXX XXXXX
X       X       X
X XXX XXXXX XXX X
X X X       X X X
X X XXXXXXXXX X X
X       X       X
XXXXX XXXXX XXXXX
